WE./Images/XPM/clown-704x704.xpm

N			O./Images/XPM/vitruve-704.xpm

	SO./Images/XPM/trigonometric-functions-704x704.xpm
EA./Images/XPM/JUL-704.xpm

	F	 225, 150,225

	C 1 2 5,1 5 0	,1 0 0


1111111111111111111111111
1000N00000110000000000001
1011000001110000000000001
1111000000000000000000001
   1111110110000011100001
1110000000110000011101111111111
11110111111111011100000010001
11110111111111011101010010001
11000000110101011100000010001
10000000000000001100000010001
10000000000000001101010010001
110000011101010111110111100111
11110111 1110101 101111010001
11111111 11111111111111111111