N         O ./path_to_the_north_texture
N  O /Users/cben-bar/cursus/Cub3D/Images/PNG/ACAB_496.png
NO /Users/cben-bar/Downloads/pp
     SO       /Users/cben-bar/cursus/Cub3D/Images/PNG/ACAB.png
      W          E /Users/cben-bar/cursus/Cub3D/Images/PNG/bloby.png
EA/Users/cben-bar/cursus/Cub3D/Images/PNG/flm.png
   C    225 , 30, 0
            F    thj   1 23      ,   26 , 79
            F     1 23      ,   26 , 79

111111111111
C /Users/cben-bar/Downloads/pp
1111111111111111111111111
1000000000110000000000001
1011000001110000000000001
1111000000000000000000001
   1111110110000011100001
11100000001100000111011111 111111
11110111111111011100000010001
11110111111111011101010010001
11000000110101011100000010001
10000000000000001100000010001
10000000000000001101010010001
11000001110101011111011110N0111
11110111 1110101 101111010001
11111111 11111111111111111111