NO./Images/XPM/vitruve-704.xpm
SO./Images/XPM/ravenna_mosaics_704x704.xpm

WE./Images/XPM/clown-704x704.xpm

EA./Images/XPM/JUL-704.xpm


F 225,150,225


C125, 150, 100

111111
100001
101001
110]N]
110111
 101
 1011111111111
 1000000000001
 1111011111101
    101    101
	101    101
	111    111