WE./Images/XPM/clown-704x704.xpm

NO./Images/XPM/ravenna_mosaics_704x704.xpm

		SO ./Images/XPM/trigonometric-functions-704x704.xpm

EA./Images/XPM/s_n01_21232443.xpm

F 225,150,225


C125, 150, 100


111111111111
111110000001
100000000001
111000W00001
  1000000001
  101111111
  101
  101
  101111
  100001
 100001
  111101
  111101111111111111111111111111
  1111000000000000000000000000001
  111111111111111111111111111111 




