NO./Images/XPM/ACAB_496.xpm

SO./Images/XPM/ACAB.xpm

WE./Images/XPM/bloby.xpm

EA./Images/XPM/flm.xpm

F123,26,79

C,30,0
C 225, 0 , 0

1111111111111111111111111
1000010000001100000101001
1000000001101010000000001
11000N0110010101110001111
10000111 1000101 10000001
11111111 1111111 11111111