SO./Images/XPM/ravenna_mosaics_704x704.xpm
WE./Images/XPM/clown-704x704.xpm
N O./Images/XPM/vitruve-704.xpm
EA./Images/XPM/JUL-704.xpm




F 225,150, 225


C125,150,10






11111111111111111111111111111
1000010000001100000101001
10000000011100000000000011
1100000110010101110001111
10000111 1000101 10000001
10000001 1111111 10W00001
10000001 1111111 10000001
 1111111 1111111 1111111
